###############################
#~e#~~~~~~~~~~#~~~~~##~#~~~~~~#
#~##~###~###~####~#~~#~#~#~##~#
#~~##~~#~##~~~#~#~##~~~#~~~#~~#
##~~##~#~~~~#~~~~~###~##~###~##
#~#~#~~~~#~~#~###~~#~~#~~#~#~~#
#~#~~#~########~#####~~~~#~##~#
#~#~~~~~~~~##+~~~~~#####~~~##~#
#~~~##~###~~##~#~###~~~###~#~~#
#~#~#~~~~~~~~~~~~~~~~#~~E#~#$~#
############################### 